1111111111111111111111111111111111
1P10001000000000000000100000000001
1010111111111110111111111101111101
1010000000000010000000000100000101
1111111111101111110111111111111101
10C0000000100000000100000000000001
1111011101111111110111111110111111
1000000100000000000000000000000CE1
1111111111111111111111111111111111